13 24
XXXXXXXXXXXXXXXXXXXXXXXX
X|||+|||||||+||+|||||||X
X|--|-------#---|--.--|X
X|--+.......|---|--.--|X
X|..|-------|---#--.--|X
X|--|||||||||||||--.--|X
X|--|---.---|---|--.--|X
X|||+|||||||+...|||||||X
X|--|-------|------|--|X
X+||||||||#|+|||#|||..|X
X|----|--.---------#---X
X||||||||||||||+||||---X
XXXXXXXXXXXXXXXXXXXXXXXX
9
H 18 5 N -
H 10 9 N #
H 21 6 N -
B 5 7 W |
B 13 7 W .
A 1 11 N |
X 18 1 E |
C 8 5 E |
T 19 9 W |